
ZVAD--G--A--S--XBMS++J--MH--
CNADG--C--N--MW--AQ++B++
ZVAD--G--A--S--XBMS++J--MQ--
CNAG--C--N==J==CQY==J==NDE++W++

ZVAD--G--A--S--XBMS++J--SH--
CNG++--J--ADQ++--S--
ZVH++==H==J==E==BSJW++++
CNA=D=Q-+++++Q--W--

VAFHE--T--Q--W--BSGW++J--H--
CNADG--G==G==W--Q--Q++DQ--W--
VAFHE--T==T==Q--W--BSGW++W--E--
NDHY--T--E--T--JT--D==G==HQ--W--

VAFHE--T==T==Q--W--BSGW++J--H--
CMSG--G==G==W--Q--NADGQ--H==D==Q--W--
VAFHE--R==E==--W==E==BSGW--Y++W--
ZAQ--A--F--G--F--Z--F--G--

D++--B--ZA++--==H==

VQ--B==AH==FQ--F==VH==BQ==SQ==HQ==SE==GW--B==Q==
C==Q==S==G==DH==GQ==BQ==DH==NQ==DQ==HQ==QE==DW--H==DQ==
VW==QA==GW==Q==FW==Q==FW==VQ==BW==SW==GE==S==GE--==Q==
ZAW==GQ==AW==DQ==W==A==W==DQ==ZAW==W==AGE==R==BGJW==Q==Q==S==

VAGH==ZE==B==E==AE==W==W==VQ==BW==SQ==HW==Q==SE--E--
CE==SE==GE==QE==E==W==W==CQ==NW==DQ==HW==Q==DE==A==NE==C==
XHQE==AE==GE==QE==E==W==W==VQ==BW==SQ==GE++SE==BH==
ZQ==AH==FQ==H==Q==AH==FQ==GH==ZADQ==BH==AE==DGE==JGM==BW==MQ==B==

CNH==DE==HE==AW==NDGW==Q==AW==NQ==XBGW==SQ==MW==SQ==BMGW==Q==BE--
ZVFH==AE==HE==AW==VNDW==Q==AW==VQ==CW==AQ==GW==AQ==BDW==AQ==GE==A==
X==SHE==NHE==SFW==FHW==DQ==FHW==NDQ==XS==VQ==NHW==AQ==NFW==Q==SE==N==
ZV==SH==HQ==SH==NFQ==H==Q==VH==XBSGQ==H==BGQ==SGQ==GQ==Q==BGE==C==

NHQ==DG==HT==AR==HR==E==NE==DW==BW==SQ==JW==GQ==SJW--BGE--
VHW==AQ==HW==Q==FHW==GQ==E==F==CGW==AQ==DGW==GQ==ADGQE==G==DE==A==
XE==FH==HQ==SH==NFQ==H==FHQ==NH==SQ==FH==NQ==AW==SF==AQ==FQ==S==
VQ==SH==HQ==SH==NFQ==H==FQ==Q==XBSG==SQ==BGQ==SW==XBGQ==X==XBSGW--

ZVDGE==V==NGQT==AT==AQ==F==AHW==V==XBSJW==S==J==S==GJ==B==SH==X==
CSG==M==SG==SG==SGW==J==SDQ==D==CNDHQ==D==H==ND==AHQ==N==SJW==C==
ZVDQE==A==AFT==QT==DQ==F==HW==AG==XBJW==S==M==S==GJW==G==GJE==S==
CNQEY==C==NHT==D==GE==A==NQT==D==CNQT==D==H==D==XBQ==S==SGW==S==

ZVDGE==V==NGQT==A==AQ==F==AHW==V==XBSJW==S==J==S==GJ==B==SH==X==
CSG==M==SG==SG==SGW==J==SQ==M==CNHQ==C==N==D==CNQ==A==NW==C==
ZVGE==A==FHR==AGQE====F==AHW==VE==XBGJW==S==JY==S====B==SW==B==\
ZFQ==Z==B==A====A==F==B==ZD==AR==GE==AQ==G==BD==A====

V=F=H-A--FH--==Q==BGJ--SQ--GW--S--
CDG--M--DW--==J==NHQ--D--H--D--
VFH--A--FH--==Q==BGJ--SQ--GW--S--
ZB=A=D=G=Q

+++++++++++++++++++++++++++++++++++++++++++++++++++++++++++++++++++++++++++++++++++++++

扒谱：呱呱瓜
QQ群： 
791190008
928469481
771671566
982830053	
644482967

按键精灵速度：95


扒谱不易，借用还请标明出处！感谢！